31 15
 4  3  3  3  3  3 22 30 16  3  3  3  3  3 10
21 18 18 18 18 18 18 35 18 18 18 18 18 18 21
21 18  0  6  6  6  6  6  6  6  6  6 12 18 21
21 18  2  8  8  8  8  7  7  8  8  8 14 18 21
21 18 18 18 18 18 18  1 13 18 18 18 18 18 21
21 18  0  6  6 12 18  1 13 18  4  3  9 18 21
21 18  1  7  7 13 19  1 13 18 21 30 30 18 21
21 18  2  8  8 14 18  1 13 18 21 30 17 18 21
21 18 18 18 18 18 18  1 13 18 21 30 21 18 21
21 18  0  6  6  6  6  7 13 18 21 30 21 18 21
21 18  2  8  8  8  8  8 14 18 21 30 21 18 21
21 18 18 18 18 18 18 18 18 18 21 30 21 18 21
21 18  4  3  3  3  3  3  3  3 11 30 21 18 21
21 18 21 30 30 30 30 30 30 30 21 30 21 18 21
21 18 21 30  4  3  3  3 10 30 21 30 21 18 21
21 18 21 30 21 30 30 30 21 31 21 30 21 18 21
21 18 21 30 21 34 32 33 23 30 23 30 21 18 21
21 18 21 30 21 30 30 30 25 30 30 30 21 18 21
21 18 21 30 29  3  3  3  3  3  3  3 22 18 21
21 18 21 30 21 18 18 18 18 18 18 18 18 18 21
21 18 21 30 21 18  0  6  6  6  6  6 12 18 21
21 18 21 30 21 18  1  7  8  8  8  8 14 18 21
21 18 21 30 21 18  1 13 18 18 18 18 18 18 21
21 18 23 30 21 18  1 13 18  0  6  6 12 18 21
21 18 30 30 21 18  1 13 19  1  7  7 13 18 21
21 18  5  3 22 18  1 13 18  2  8  8 14 18 21
21 18 18 18 18 18  1 13 18 18 18 18 18 18 21
21 18  0  6  6  6  7  7  6  6  6  6 12 18 21
21 18  2  8  8  8  8  8  8  8  8  8 14 18 21
21 18 18 18 18 31 18 18 18 18 18 18 18 18 21
16  3  3  3  3  3 10 30  4  3  3  3  3  3 22