21 27
04 03 03 03 03 22 30 16 03 03 03 27 24 03 03 03 10 30 21 30 04 03 03 03 03 03 10
21 18 18 19 18 18 18 18 18 18 18 01 13 18 18 18 21 30 21 30 21 18 18 19 18 18 21
21 18 00 12 18 04 03 03 03 09 18 01 13 18 17 18 16 03 22 30 23 18 00 06 12 18 21
21 18 01 13 18 21 18 18 18 18 18 01 13 18 21 18 18 18 18 18 18 18 01 07 13 18 21
21 18 02 14 18 21 18 00 06 12 18 02 14 18 16 03 03 09 18 05 03 03 26 08 14 18 21
21 18 18 18 18 21 18 01 07 13 18 18 18 18 18 18 18 18 18 18 18 18 18 18 18 18 21
21 18 05 03 03 22 18 02 08 15 03 03 09 30 05 03 27 12 18 04 03 09 18 00 12 18 21
21 18 18 18 18 18 18 30 30 30 30 30 30 30 30 30 01 13 18 21 18 18 18 01 13 18 21
21 18 00 12 18 05 03 03 27 12 30 04 03 03 10 30 02 14 18 21 18 17 18 02 14 18 21
21 18 01 13 18 18 18 18 01 13 30 23 30 33 21 30 30 30 18 21 18 21 18 18 18 18 21
21 18 01 28 03 03 09 18 01 13 32 25 30 34 21 30 05 03 03 11 31 29 03 03 03 03 11
21 18 01 13 18 18 18 18 01 13 30 17 30 35 21 30 30 30 18 21 18 21 18 18 18 18 21
21 18 02 14 18 05 03 03 26 14 30 16 03 03 22 30 00 12 18 21 18 23 18 00 12 18 21
21 18 18 18 18 18 18 30 30 30 30 30 30 30 30 30 01 13 18 21 18 18 18 01 13 18 21
21 18 05 03 03 10 18 00 06 24 03 03 09 30 05 03 26 14 18 16 03 09 18 02 14 18 21
21 18 18 18 18 21 18 01 07 13 18 18 18 18 18 18 18 18 18 18 18 18 18 18 18 18 21
21 18 00 12 18 21 18 02 08 14 18 00 12 18 04 03 03 09 18 05 03 03 27 06 12 18 21
21 18 01 13 18 21 18 18 18 18 18 01 13 18 21 18 18 18 18 18 18 18 01 07 13 18 21
21 18 02 14 18 16 03 03 03 09 18 01 13 18 23 18 04 03 10 30 17 18 02 08 14 18 21
21 18 18 19 18 18 18 18 18 18 18 01 13 18 18 18 21 30 21 30 21 18 18 19 18 18 21
16 03 03 03 03 10 30 04 03 03 03 26 15 03 03 03 22 30 21 30 16 03 03 03 03 03 22
30 30 30 30 30 03 30 03 30 30 30 30 30 30 30 30 03 30 03 30 30 30 30 30 30 30 30