32 15
 4  3  3  3  3  3  3  3  3  3  3  3  3  3 10
21 18 19 18 18 18 18 18 18 18 18 18 18 18 21
21 18  0  6  6  6  6  6  6  6  6  6 12 30 21
21 18  2  8  8  8  8  7  7  8  8  8 14 30 21
21 18 30 30 30 30 30  1 13 18 18 18 18 18 21
21 18  0  6  6 12 30  1 13 18  4  3  9 30 21
21 18  1  7  7 13 30  1 13 18 21 30 30 30 21
21 18  2  8  8 14 30  1 13 18 21 30 30 30 21
21 18 30 30 30 30 30  1 13 18 21 30 30 30 21
21 18  0  6  6  6  6  7 13 18 21 30 30 30 21
21 18  2  8  8  8  8  8 14 18 21 30 30 30 21
21 18 18 18 18 18 18 18 18 18 21 30 30 30 21
21 18  5  3  3  3  3  3  3  3 11 30 30 30 21
21 18 30 30 30 30 30 30 30 30 21 30 30 30 21
21 18 30 30 30 30 30 30 30 30 21 30 30 30 21
21 18 30 30 30 30 30 30 30 30 30 30 30 30 21
21 18 30 30 30 30 30 30 30 30 30 30 30 30 21
21 18 30 30 30 30 30 30 30 30 30 30 30 30 21
21 18 30 30 30 30 30 30 30 30 30 30 30 30 21
21 18 30 30 30 30 30 30 30 30 30 30 30 30 21
21 18 30 30 30 30 30 30 30 30 30 30 30 30 21
21 18 30 30 30 30 30 30 30 30 30 30 30 30 21
21 18 30 30 30 30 30 30 30 30 30 30 30 30 21
21 18 30 30 30 30 30 30 30 30 30 30 30 30 21
21 18 30 30 30 30 30 30 30 30 30 30 30 30 21
21 18 30 30 30 30 30 30 30 30 30 30 30 30 21
21 18 30 30 30 30 30 30 30 30 30 30 30 30 21
21 18 30 30 30 30 30 30 30 30 30 30 30 30 21
21 18 30 30 30 30 30 30 30 30 30 30 30 30 21
21 18 30 30 30 30 30 30 30 30 30 30 30 30 21
16  3  3  3  3  3  3  3  3  3  3  3  3  3 22
