21 11 02
04 03 03 03 22 30 16 03 03 03 10
21 19 18 18 18 18 18 18 18 18 21
21 18 04 03 09 18 05 03 10 18 21
21 18 23 18 31 18 18 18 23 18 21
21 18 18 18 17 18 17 18 18 18 21
29 03 09 18 23 18 23 30 05 03 11
21 18 18 18 18 18 18 30 18 18 21
21 18 17 18 04 03 10 30 17 18 21
21 18 21 18 21 30 21 30 21 18 21
21 18 21 18 23 30 21 30 21 18 21
21 18 21 32 25 34 21 31 21 18 21
21 18 21 18 17 30 21 30 21 18 21
21 18 21 18 21 30 21 30 21 18 21
21 18 23 18 16 03 22 30 23 18 21
21 18 18 18 18 18 18 30 18 18 21
29 03 09 18 17 18 17 30 05 03 11
21 18 18 18 23 18 23 18 18 18 21
21 18 17 18 18 18 18 18 17 18 21
21 18 16 03 09 18 05 03 22 18 21
21 18 18 18 18 18 18 18 18 19 21
16 03 03 03 10 30 04 03 03 03 22


